111111111
100000911
100u00001
11000011
111101111