111110111
1P0000001
 10000001
1P000001
111111111