111111111
1000001E1
101010101
1P1C10001
111111111