11111111111111
1P0010000000C1
10001001111111
100C0000000001
1111000001C001
1C010111111111
100000000000E1
11111111111111